NO ./textures/test_n_letter.xpm
SO ./textures/test_s_letter.xpm
WE ./textures/test_w_letter.xpm
EA ./textures/test_e_letter.xpm

C 159,186,205
F 143,32,33

11111     
11111                   
