NO ./textures/test_n_letter.xpm
SO ./textures/test_s_letter.xpm
WE ./textures/test_w_letter.xpm
EA ./textures/test_e_letter.xpm

C 159,186,205
F 143,32,33

        1111111111111111111111111
            1000000000110000000000001
1011000001110000000000001
                    1001000000000000000000001
111111111011000001110000000000001
100000000011000001110111111111111
11110111111111011100000010001
11110111111111011101010010001
11000000110101011100000010001                    111111
10000000000000001100000010001                           100001
10000000000000001101010010001                  111111
11000001110101011111011110N0111
11110111 1110101 101111010001
11111111 1111111 111111111111