NO ./textures/test_n_letter.xpm
SO ./textures/test_s_letter.xpm
WE ./textures/test_w_letter.xpm
EA ./textures/test_e_letter.xpm

C 159,186,20
F 143,32,33


           1111111111111111111111111
           1000000000110000000000001
           1011000001110000000000001
           1001000000000000000001111
111111111111000001110000000000001
100000000011000001110111111111111
11110111111111011100000010001              1111111
11110111111111011101010010001              1000001
11000000110101011100011110001              1000001
1000000010000000110001 110001              1111111
10000000000000001101011110001
1100000111010101111101111010111
11110111 1110101 101111010001
11111111 1111111 111111111111          S
